R 1920 1080
SO ./texturexpm/168/gypte.xpm
NO ./texturexpm/168/grille.xpm
EA ./texturexpm/168/halogris.xpm
WE ./texturexpm/168/haloski.xpm
S ./texturexpm/sprite/117.xpm
C 0 	,	0,  200
F 50,50,         40
1111111111111111111111111
1000000000111000000000001
1000000000000000000000001
1000000000111000000000001
1000000000111000000000001
1000000000111000000000001
1111000111111111100001111
1111000111111111100001111
1000000000111000000000001
1000000000111000W00000001
1000000000111000000000001
1000000000000000000000001
1000000000111000000000001
1111111111111111111111111