R 1200 1200
NO textures/wall_1.xpm
SO textures/wall_2.xpm
WE textures/wall_3.xpm
EA textures/wall_4.xpm
S textures/sprite_1.xpm
C 44, 4, 33
F 51,198, 255


11111111111111111
10000010000000001
10N00001010001111
1111111111111111