R 800 600
NO textures/wall_1.xpm
SO textures/wall_2.xpm
WE textures/wall_3.xpm
EA textures/wall_4.xpm
S textures/sprite_1.xpm
C 255, 0, 33
F 51,198, 255


11111111111111111
10000000000200001
10000000000000001
10S00001010001111
1111111111111111