R 1280 720
NO textures/wall_1.xpm
SO textures/wall_2.xpm
WE textures/wall_3.xpm
EA textures/wall_4.xpm
S textures/sprite_1.xpm
F 44, 4, 33
C 51,198,22


11111111111111111
10000010000000001
10N00001010001111
1111111111111111