R 1280 720
NO textures/wall_1.xpm
SO textures/wall_2.xpm
WE textures/wall_3.xpm
EA textures/wall_4.xpm
S textures/sprite_1.xpm
F 184,113,39
C 51,198,227


111111
100001
100201
100001
100001
100001
100001
100001
10000011111111111111111111111111111111111
100000000000000000000000000010111111111111
1111111100110110000000011100000020000010001
 111    110001111001111111001111111111111111
11  11111110001000111111000111
101100011111100011111111111111111
 11101111111110111010100100000011111111111
1100000011010101110000001000111
10002000000000001100000010001
10000000000000000101010000001
110000001101010111110111100111111
111101111 1011101011111011110000011111
11100N01111111101111000000011111111001
  11111      1111   11111111       11111
