R 1280 720
NO textures/cobble.xpm
SO textures/grass_1.xpm
WE textures/mossy_cobble.xpm
EA textures/grass_1.xpm
S textures/cobweb.xpm
F 90,101,33
C 128,218,235

11111111111111111111111111111
10000000001100000000000000001
10110020011100000000000010001
10010020000000222222000010001
10110020011100000000000010001
10000000001100000111011110001
11110111111111011100000010001
11110111111111011101010010001
11000000110101011100N00010001
10000000000000001100000010001
10000222222000001102010020001
11000000110101000000000000001
11110111110101000000202000001
10000000001100000100000010001
10000000000000002000200001001
11111111111111111111111111111