R 848 480
NO textures/sky_1.xpm
SO textures/sss.xpm
WE textures/sky_1.xpm
EA textures/sky_1.xpm
S textures/sprite_1.xpm
SU textures/sprite_2.xpm
SC textures/sprite_3.xpm
F 184,113,39
C 51,198,227

111111111111
110000000001
110000000011
111100000111
111111111111